"filename", "language", "TypeScript JSX", "TypeScript", "JSON", "JavaScript", "comment", "blank", "total"
"/Users/mohammadkiyan/Documents/GitHub/ConjuringEscaperoom/src/Dashboard/backend/dist/controllers/recieverController.js", "JavaScript", 0, 0, 0, 31, 0, 1, 32
"/Users/mohammadkiyan/Documents/GitHub/ConjuringEscaperoom/src/Dashboard/backend/dist/index.js", "JavaScript", 0, 0, 0, 5, 0, 0, 5
"/Users/mohammadkiyan/Documents/GitHub/ConjuringEscaperoom/src/Dashboard/backend/dist/middleware/deleteByID copy.js", "JavaScript", 0, 0, 0, 31, 0, 1, 32
"/Users/mohammadkiyan/Documents/GitHub/ConjuringEscaperoom/src/Dashboard/backend/dist/middleware/deleteByID.js", "JavaScript", 0, 0, 0, 47, 2, 1, 50
"/Users/mohammadkiyan/Documents/GitHub/ConjuringEscaperoom/src/Dashboard/backend/dist/middleware/getAll.js", "JavaScript", 0, 0, 0, 31, 0, 1, 32
"/Users/mohammadkiyan/Documents/GitHub/ConjuringEscaperoom/src/Dashboard/backend/dist/middleware/saveToDB copy.js", "JavaScript", 0, 0, 0, 31, 0, 1, 32
"/Users/mohammadkiyan/Documents/GitHub/ConjuringEscaperoom/src/Dashboard/backend/dist/middleware/saveToDB.js", "JavaScript", 0, 0, 0, 1, 0, 0, 1
"/Users/mohammadkiyan/Documents/GitHub/ConjuringEscaperoom/src/Dashboard/backend/dist/middleware/updateByID.js", "JavaScript", 0, 0, 0, 38, 0, 1, 39
"/Users/mohammadkiyan/Documents/GitHub/ConjuringEscaperoom/src/Dashboard/backend/dist/models/crossModel copy.js", "JavaScript", 0, 0, 0, 29, 0, 1, 30
"/Users/mohammadkiyan/Documents/GitHub/ConjuringEscaperoom/src/Dashboard/backend/dist/models/playerModel.js", "JavaScript", 0, 0, 0, 18, 0, 1, 19
"/Users/mohammadkiyan/Documents/GitHub/ConjuringEscaperoom/src/Dashboard/backend/dist/models/recieverModel.js", "JavaScript", 0, 0, 0, 15, 0, 1, 16
"/Users/mohammadkiyan/Documents/GitHub/ConjuringEscaperoom/src/Dashboard/backend/dist/models/senderModel.js", "JavaScript", 0, 0, 0, 15, 0, 1, 16
"/Users/mohammadkiyan/Documents/GitHub/ConjuringEscaperoom/src/Dashboard/backend/dist/models/teamModel.js", "JavaScript", 0, 0, 0, 14, 0, 1, 15
"/Users/mohammadkiyan/Documents/GitHub/ConjuringEscaperoom/src/Dashboard/backend/dist/routes/crossRouter copy.js", "JavaScript", 0, 0, 0, 17, 0, 1, 18
"/Users/mohammadkiyan/Documents/GitHub/ConjuringEscaperoom/src/Dashboard/backend/dist/routes/gameRouter.js", "JavaScript", 0, 0, 0, 21, 0, 1, 22
"/Users/mohammadkiyan/Documents/GitHub/ConjuringEscaperoom/src/Dashboard/backend/dist/routes/recieverRouter.js", "JavaScript", 0, 0, 0, 21, 0, 1, 22
"/Users/mohammadkiyan/Documents/GitHub/ConjuringEscaperoom/src/Dashboard/backend/index.ts", "TypeScript", 0, 5, 0, 0, 0, 3, 8
"/Users/mohammadkiyan/Documents/GitHub/ConjuringEscaperoom/src/Dashboard/backend/middleware/deleteByID.ts", "TypeScript", 0, 40, 0, 0, 2, 7, 49
"/Users/mohammadkiyan/Documents/GitHub/ConjuringEscaperoom/src/Dashboard/backend/middleware/getAll.ts", "TypeScript", 0, 25, 0, 0, 0, 4, 29
"/Users/mohammadkiyan/Documents/GitHub/ConjuringEscaperoom/src/Dashboard/backend/middleware/saveToDB.ts", "TypeScript", 0, 1, 0, 0, 0, 0, 1
"/Users/mohammadkiyan/Documents/GitHub/ConjuringEscaperoom/src/Dashboard/backend/middleware/updateByID.ts", "TypeScript", 0, 36, 0, 0, 0, 7, 43
"/Users/mohammadkiyan/Documents/GitHub/ConjuringEscaperoom/src/Dashboard/backend/models/playerModel.ts", "TypeScript", 0, 15, 0, 0, 0, 2, 17
"/Users/mohammadkiyan/Documents/GitHub/ConjuringEscaperoom/src/Dashboard/backend/models/recieverModel.ts", "TypeScript", 0, 12, 0, 0, 0, 2, 14
"/Users/mohammadkiyan/Documents/GitHub/ConjuringEscaperoom/src/Dashboard/backend/routes/gameRouter.ts", "TypeScript", 0, 16, 0, 0, 0, 5, 21
"/Users/mohammadkiyan/Documents/GitHub/ConjuringEscaperoom/src/Dashboard/backend/routes/recieverRouter.ts", "TypeScript", 0, 16, 0, 0, 0, 4, 20
"/Users/mohammadkiyan/Documents/GitHub/ConjuringEscaperoom/src/Dashboard/frontend/conjuring_escaperoom_dashboard/package-lock.json", "JSON", 0, 0, 8656, 0, 0, 0, 8656
"/Users/mohammadkiyan/Documents/GitHub/ConjuringEscaperoom/src/Dashboard/frontend/conjuring_escaperoom_dashboard/package.json", "JSON", 0, 0, 1, 0, 0, 0, 1
"/Users/mohammadkiyan/Documents/GitHub/ConjuringEscaperoom/src/Dashboard/frontend/conjuring_escaperoom_dashboard/src/api/addModel.ts", "TypeScript", 0, 22, 0, 0, 0, 1, 23
"/Users/mohammadkiyan/Documents/GitHub/ConjuringEscaperoom/src/Dashboard/frontend/conjuring_escaperoom_dashboard/src/api/deleteModel.ts", "TypeScript", 0, 17, 0, 0, 0, 1, 18
"/Users/mohammadkiyan/Documents/GitHub/ConjuringEscaperoom/src/Dashboard/frontend/conjuring_escaperoom_dashboard/src/api/updateCross.ts", "TypeScript", 0, -21, 0, 0, 0, -1, -22
"/Users/mohammadkiyan/Documents/GitHub/ConjuringEscaperoom/src/Dashboard/frontend/conjuring_escaperoom_dashboard/src/api/updateModel.ts", "TypeScript", 0, 21, 0, 0, 0, 1, 22
"/Users/mohammadkiyan/Documents/GitHub/ConjuringEscaperoom/src/Dashboard/frontend/conjuring_escaperoom_dashboard/src/components/Cards/TeamCard.tsx", "TypeScript JSX", 36, 0, 0, 0, 1, 5, 42
"/Users/mohammadkiyan/Documents/GitHub/ConjuringEscaperoom/src/Dashboard/frontend/conjuring_escaperoom_dashboard/src/components/Forms/GameForm.tsx", "TypeScript JSX", 86, 0, 0, 0, 0, 13, 99
"/Users/mohammadkiyan/Documents/GitHub/ConjuringEscaperoom/src/Dashboard/frontend/conjuring_escaperoom_dashboard/src/components/Forms/PlayerForm.tsx", "TypeScript JSX", 54, 0, 0, 0, 0, 7, 61
"/Users/mohammadkiyan/Documents/GitHub/ConjuringEscaperoom/src/Dashboard/frontend/conjuring_escaperoom_dashboard/src/components/Forms/TeamForm.tsx", "TypeScript JSX", 40, 0, 0, 0, 1, 10, 51
"/Users/mohammadkiyan/Documents/GitHub/ConjuringEscaperoom/src/Dashboard/frontend/conjuring_escaperoom_dashboard/src/components/PortableFinder/mediaPlayer/Explorer.tsx", "TypeScript JSX", 7, 0, 0, 0, 1, 2, 10
"/Users/mohammadkiyan/Documents/GitHub/ConjuringEscaperoom/src/Dashboard/frontend/conjuring_escaperoom_dashboard/src/components/PortableFinder/mediaPlayer/Index.tsx", "TypeScript JSX", 7, 0, 0, 0, 0, 2, 9
"/Users/mohammadkiyan/Documents/GitHub/ConjuringEscaperoom/src/Dashboard/frontend/conjuring_escaperoom_dashboard/src/components/PortableFinder/mediaPlayer/MediaItem.tsx", "TypeScript JSX", 5, 0, 0, 0, 0, 2, 7
"/Users/mohammadkiyan/Documents/GitHub/ConjuringEscaperoom/src/Dashboard/frontend/conjuring_escaperoom_dashboard/src/components/PortableFinder/signal/EditableField.tsx", "TypeScript JSX", 33, 0, 0, 0, 0, 9, 42
"/Users/mohammadkiyan/Documents/GitHub/ConjuringEscaperoom/src/Dashboard/frontend/conjuring_escaperoom_dashboard/src/components/PortableFinder/signal/Signal.tsx", "TypeScript JSX", 10, 0, 0, 0, 0, 3, 13
"/Users/mohammadkiyan/Documents/GitHub/ConjuringEscaperoom/src/Dashboard/frontend/conjuring_escaperoom_dashboard/src/components/PortableFinder/signal/signalFinder/Index.tsx", "TypeScript JSX", -29, 0, 0, 0, 0, 0, -29
"/Users/mohammadkiyan/Documents/GitHub/ConjuringEscaperoom/src/Dashboard/frontend/conjuring_escaperoom_dashboard/src/components/Tables/Index.tsx", "TypeScript JSX", 56, 0, 0, 0, 0, 9, 65
"/Users/mohammadkiyan/Documents/GitHub/ConjuringEscaperoom/src/Dashboard/frontend/conjuring_escaperoom_dashboard/src/components/TagFinder/Index.tsx", "TypeScript JSX", -1, 0, 0, 0, 0, 0, -1
"/Users/mohammadkiyan/Documents/GitHub/ConjuringEscaperoom/src/Dashboard/frontend/conjuring_escaperoom_dashboard/src/components/TagFinder/TagReader.tsx", "TypeScript JSX", 6, 0, 0, 0, 0, 0, 6
"/Users/mohammadkiyan/Documents/GitHub/ConjuringEscaperoom/src/Dashboard/frontend/conjuring_escaperoom_dashboard/src/pages/Game.tsx", "TypeScript JSX", 98, 0, 0, 0, 2, 10, 110
"/Users/mohammadkiyan/Documents/GitHub/ConjuringEscaperoom/src/Dashboard/frontend/conjuring_escaperoom_dashboard/src/pages/index.tsx", "TypeScript JSX", 4, 0, 0, 0, 0, 1, 5
"/Users/mohammadkiyan/Documents/GitHub/ConjuringEscaperoom/src/Dashboard/frontend/conjuring_escaperoom_dashboard/src/redux/reducers/forms/gameForm.ts", "TypeScript", 0, 53, 0, 0, 0, 5, 58
"/Users/mohammadkiyan/Documents/GitHub/ConjuringEscaperoom/src/Dashboard/frontend/conjuring_escaperoom_dashboard/src/redux/reducers/forms/playerForm.ts", "TypeScript", 0, 68, 0, 0, 4, 8, 80
"/Users/mohammadkiyan/Documents/GitHub/ConjuringEscaperoom/src/Dashboard/frontend/conjuring_escaperoom_dashboard/src/redux/reducers/forms/teamForm.ts", "TypeScript", 0, 29, 0, 0, 0, 6, 35
"/Users/mohammadkiyan/Documents/GitHub/ConjuringEscaperoom/src/Dashboard/frontend/conjuring_escaperoom_dashboard/src/redux/reducers/goblinFinder.ts", "TypeScript", 0, 4, 0, 0, 0, -1, 3
"/Users/mohammadkiyan/Documents/GitHub/ConjuringEscaperoom/src/Dashboard/frontend/conjuring_escaperoom_dashboard/src/redux/reducers/index.ts", "TypeScript", 0, 10, 0, 0, 0, 1, 11
"/Users/mohammadkiyan/Documents/GitHub/ConjuringEscaperoom/src/Dashboard/frontend/conjuring_escaperoom_dashboard/src/redux/reducers/reciever.ts", "TypeScript", 0, 35, 0, 0, 4, 7, 46
"Total", "-", 412, 404, 8657, 365, 17, 149, 10004